W 11
H 7
P 1 1
MAP
###########
#.........#
#.###.###.#
#.###.###.#
#.###.###.#
#.........#
###########