W 9
H 7
P 1 1
MAP
#########
#.......#
#.#####.#
#.#####.#
#.#####.#
#.......#
#########