W 13
H 11
P 1 1
R 1 11
G 9 1
Y 9 11
MAP
#############
#...........#
#_###_###_#_#
#__.._o_.___#
#_###___###_#
#_____#_____#
#_###___###_#
#__.._o_.___#
#_###_###_#_#
#...........#
#############