W 15
H 15
P 7 7
R 1 7
G 13 7
Y 7 1
B 1 1
MAP
###############
#*___________*#
#_###_###_#_#_#
#_._________._#
#_#_###___###_#
#_._c___.___c.#
#_###___o___###
#_._.___.___._#
#_###___o___###
#_._c___.___c.#
#_#_###___###_#
#_._________._#
#_###_###_#_#_#
#*___________*#
###############