W 11
H 9
P 1 1
MAP
###########
#.........#
#_#####_#_#
#_.....___#
#_#####_#_#
#___.....__
#_#####_#_#
#.........#
###########