W 15
H 13
P 6 7
R 1 7
G 11 7
Y 6 1
B 1 1
MAP
###############
#*_.___.___._*#
#_###_###_#_#_#
#_._________._#
#_#_###___###_#
#_._c___o___c.#
#_###_______###
#_._c___o___c.#
#_#_###___###_#
#_._________._#
#_###_###_#_#_#
#*_.___.___._*#
###############