W 11
H 9
P 1 1
R 7 9
MAP
###########
#.........#
#.#####_#_#
#.#___#__.#
#...#.#__.#
#.#___#__.#
#.#####_#_#
#.........#
###########