W 13
H 9
P 1 1
R 1 11
G 7 1
MAP
#############
#...........#
#_###_###_#_#
#__..___..__#
#_###___###_#
#__..___..__#
#_###_###_#_#
#...........#
#############