W 13
H 9
P 1 1
R 1 11
G 7 1
Y 7 11
MAP
#############
#...........#
#_###_###_#_#
#__.__o__.__#
#_###___###_#
#__.__o__.__#
#_###_###_#_#
#...........#
#############