W 13
H 11
P 5 6
R 1 6
G 9 6
Y 5 1
B 1 1
MAP
#############
#*___.___.*_#
#_###_###_#_#
#__._____._.#
#_###___###_#
#__._o__._._#
#_###___###_#
#__._____._.#
#_###_###_#_#
#*___.___.*_#
#############